11111111111
1    3    1
1         1
1  4   4  1
1  4   4  1
1  4   4  1
1  4   4  1
1         1
1  4   4  1
1  4   4  1
1  4   4  1
1         1
1    2    1
11111111111
